--######--
-########-
##########
##########
##########
##########
##########
##########
-########-
--######--
